111111
1E0011
1CCC11
100P11
111111