111111
1E0010
1C0C11
100P11
111111