111111
1E0011
1CXC11
100P11
111111
