111110
1E0011
1C0C11
100P11
111111