111111111111111111111
11E000101001000111111
1C00000C000C000C00C01
110000101001000111111
1C00000C000C000C00C01
110000101001000111111
1C00000C000C000C00C01
110000101001000111111
1C00000C000C000C00C01
110000101001000111111
1C00000C000C000C00C01
110000101001000111111
1C00000C000C000C00C01
110000101001000111111
1C00000C000C000C00C01
110000101001000111111
1C00000C000C000C00C01
111111111111111111101
111111111111111111101
111111000000000000001
100000000000000000001
111P10010000011110111
111111111111111111111