111111111111
1E0011111111
1CCC11111111
100P11111111
111111111111
111111111111
111111111111
111111111111
111111111111
111111111111
111111111111