111111
110011
1C0C11
100P11
111111