111111
1E0011
100011
100P11
111111