111111
1E0011
1C0C11
100111
111111