1111111
1E00111
1C0C111
100P111
1111111
1111111
1111111